SO textures/bluestone.xpm
NO textures/redbrick.xpm     
WE textures/eagle.xpm
EA textures/mossy.xpm
F 220,100,0
C 225,30,0
        1111111111111111111111111
        1000000000000000000000001
        1100000000000000000000001
        1000000N00000000000000001
111111111000000000000000000000001
100000000000000000000000000001111
100000000000001111111100000001
1000000000000001     100000001
1000000000000001 111 100000001
1000000000000001 1011100000001
1000000000000001 1000000000001
1100000111010101 1111011110101
11110111 1110111 101111010001
11111111 1111111 111111111111




