SO      textures/bluestone.xpm
NO textures/redbrick.xpm          
        WE textures/eagle.xpm
EA      textures/mossy.xpm
F 220,100,0             
                C                    100,100,100                


        11111111111111111111111111
   1     10000000001100000000000011
   1    10110000011100000000000111
        10010000000000000000000011
1111111110110000011100000000000011
100000000011000001110111111111111 
11110111111111011100000010001     
11110111111111011101010010001   
  1111111111111111111111111111
110000001101010111000000101111
100000000000000011000000100011
100N0000000000001101010010001
1100000111010101111101111000111
11110111 1110101 101111010001
11011111 1111111 111111111111
11111111



       
	   