
F 220,100,0             
WE textures/eagle.xpm

SO textures/bluestone.xpm

NO  		   textures/redbrick.xpm          

EA textures/mossy.xpm


	C 	100,100,100


111111
100101
100001
1000E1
111111



